{
  "h1": "20",
  "h2": "40",
  "h3": "60",
  "h4": "80",
  "h5": "100",
  "h6": "110"
}